Accipitridae_Accipiter_collaris	Accipitridae
Accipitridae_Accipiter_poliogaster	Accipitridae
Scolopacidae_Actitis_macularia	Scolopacidae
Apodidae_Aeronautes_andecolus	Apodidae
Apodidae_Aeronautes_montivagus	Apodidae
Ardeidae_Agamia_agami	Ardeidae
Fringillidae_Agelaius_cyanopus	Fringillidae
Fringillidae_Amaurospiza_concolor	Fringillidae
Psittacidae_Amazona_mercenaria	Psittacidae
Ramphastidae_Andigena_nigrirostris	Ramphastidae
Motacillidae_Anthus_bogotensis	Motacillidae
Motacillidae_Anthus_furcatus	Motacillidae
Rallidae_Anurolimnas_fasciatus	Rallidae
Rallidae_Anurolimnas_viridis	Rallidae
Rallidae_Aramides_calopterus	Rallidae
Psittacidae_Aratinga_wagleri	Psittacidae
Fringillidae_Arremon_taciturnus	Fringillidae
Strigidae_Asio_stygius	Strigidae
Furnariidae_Asthenes_virgata	Furnariidae
Fringillidae_Atlapetes_canigenis	Fringillidae
Fringillidae_Atlapetes_leucopis	Fringillidae
Fringillidae_Atlapetes_melanolaemus	Fringillidae
Fringillidae_Atlapetes_pallidinucha	Fringillidae
Fringillidae_Atlapetes_terborghi	Fringillidae
Tyrannidae_Attila_bolivianus	Tyrannidae
Tyrannidae_Attila_cinnamomeus	Tyrannidae
Ramphastidae_Aulacorhynchus_huallagae	Ramphastidae
Furnariidae_Automolus_paraensis	Furnariidae
Trochilidae_Boissoneaua_mathewsii	Trochilidae
Psittacidae_Bolborhynchus_orbygnesius	Psittacidae
Galbulidae_Brachygalba_albogularis	Galbulidae
Galbulidae_Brachygalba_lugubris	Galbulidae
Bucconidae_Bucco_tamatia	Bucconidae
Fringillidae_Cacicus_koepckeae	Fringillidae
Scolopacidae_Calidris_himantopus	Scolopacidae
Ramphastidae_Capito_brunneipectus	Ramphastidae
Caprimulgidae_Caprimulgus_sericocaudatus	Caprimulgidae
Picidae_Celeus_torquatus	Picidae
Picidae_Celeus_undatus	Picidae
Furnariidae_Certhiasomus_stictolaema	Furnariidae
Furnariidae_Certhiaxis_mustelina	Furnariidae
Trochilidae_Chaetocercus_heliodor	Trochilidae
Apodidae_Chaetura_brachyura	Apodidae
Apodidae_Chaetura_egregia	Apodidae
Apodidae_Chaetura_meridionalis	Apodidae
Apodidae_Chaetura_spinicaudus	Apodidae
Apodidae_Chaetura_viridipennis	Apodidae
Formicariidae_Chamaeza_mollissima	Formicariidae
Bucconidae_Chelidoptera_tenebrosa	Bucconidae
Fringillidae_Chlorophonia_cyanea	Fringillidae
Fringillidae_Chlorophonia_pyrrhophrys	Fringillidae
Strigidae_Ciccaba_albitarsis	Strigidae
Strigidae_Ciccaba_huhula	Strigidae
Certhiidae_Cinnycerthia_fulva	Certhiidae
Certhiidae_Cinnycerthia_olivascens	Certhiidae
Certhiidae_Cinnycerthia_unirufa	Certhiidae
Tyrannidae_Cnipodectes_superrufus	Tyrannidae
Coccyzidae_Coccyzus_euleri	Coccyzidae
Fringillidae_Conirostrum_ferrugineiventre	Fringillidae
Tyrannidae_Conopias_albovittatus	Tyrannidae
Tyrannidae_Conopias_cinchoneti	Tyrannidae
Tyrannidae_Conopias_parvus	Tyrannidae
Tyrannidae_Conopias_trivirgatus	Tyrannidae
Conopophagidae_Conopophaga_castaneiceps	Conopophagidae
Conopophagidae_Conopophaga_melanogaster	Conopophagidae
Cotingidae_Cotinga_cotinga	Cotingidae
Furnariidae_Cranioleuca_gutturata	Furnariidae
Furnariidae_Cranioleuca_muelleri	Furnariidae
Fringillidae_Creurgops_dentatus	Fringillidae
Tinamidae_Crypturellus_atrocapillus	Tinamidae
Tinamidae_Crypturellus_bartletti	Tinamidae
Tinamidae_Crypturellus_cinereus	Tinamidae
Tinamidae_Crypturellus_tataupa	Tinamidae
Corvidae_Cyanolyca_viridicyanus	Corvidae
Certhiidae_Cyphorhinus_thoracicus	Certhiidae
Apodidae_Cypseloides_cryptus	Apodidae
Apodidae_Cypseloides_lemosi	Apodidae
Apodidae_Cypseloides_senex	Apodidae
Fringillidae_Dacnis_albiventris	Fringillidae
Fringillidae_Dacnis_flaviventer	Fringillidae
Fringillidae_Dacnis_lineata	Fringillidae
Dendrocolaptidae_Dendrocolaptes_hoffmannsi	Dendrocolaptidae
Fringillidae_Diuca_speculifera	Fringillidae
Neomorphidae_Dromococcyx_pavoninus	Neomorphidae
Thamnophilidae_Dysithamnus_leucostictus	Thamnophilidae
Momotidae_Electron_platyrhynchum	Momotidae
Ramphastidae_Eubucco_versicolor	Ramphastidae
Fringillidae_Euphonia_cayennensis	Fringillidae
Fringillidae_Euphonia_chrysopasta	Fringillidae
Fringillidae_Euphonia_mesochrysa	Fringillidae
Fringillidae_Euphonia_minuta	Fringillidae
Fringillidae_Euphonia_rufiventris	Fringillidae
Fringillidae_Euphonia_violacea	Fringillidae
Fringillidae_Euphonia_xanthogaster	Fringillidae
Tyrannidae_Fluvicola_albiventer	Tyrannidae
Formicariidae_Formicarius_rufipectus	Formicariidae
Psittacidae_Forpus_sclateri	Psittacidae
Rallidae_Fulica_leucoptera	Rallidae
Furnariidae_Furnarius_minor	Furnariidae
Furnariidae_Furnarius_torridus	Furnariidae
Galbulidae_Galbalcyrhynchus_leucotis	Galbulidae
Galbulidae_Galbalcyrhynchus_purusianus	Galbulidae
Galbulidae_Galbula_chalcothorax	Galbulidae
Galbulidae_Galbula_cyanicollis	Galbulidae
Galbulidae_Galbula_dea	Galbulidae
Galbulidae_Galbula_galbula	Galbulidae
Galbulidae_Galbula_leucogastra	Galbulidae
Galbulidae_Galbula_tombacea	Galbulidae
Scolopacidae_Gallinago_andina	Scolopacidae
Scolopacidae_Gallinago_jamesoni	Scolopacidae
Columbidae_Geotrygon_linearis	Columbidae
Strigidae_Glaucidium_parkeri	Strigidae
Formicariidae_Grallaria_albigula	Formicariidae
Formicariidae_Grallaria_capitalis	Formicariidae
Formicariidae_Grallaria_carrikeri	Formicariidae
Formicariidae_Grallaria_erythroleuca	Formicariidae
Formicariidae_Grallaria_gigantea	Formicariidae
Formicariidae_Grallaria_haplonota	Formicariidae
Formicariidae_Grallaricula_ferrugineipectus	Formicariidae
Formicariidae_Grallaricula_peruviana	Formicariidae
Psittacidae_Hapalopsittaca_melanotis	Psittacidae
Bucconidae_Hapaloptila_castanea	Bucconidae
Trochilidae_Haplophaedia_assimilis	Trochilidae
Accipitridae_Harpagus_diodon	Accipitridae
Fringillidae_Hemithraupis_guira	Fringillidae
Thamnophilidae_Herpsilochmus_dugandi	Thamnophilidae
Thamnophilidae_Herpsilochmus_gentryi	Thamnophilidae
Pipridae_Heterocercus_aurantiivertex	Pipridae
Furnariidae_Hylexetastes_stresemanni	Furnariidae
Furnariidae_Hylexetastes_uniformis	Furnariidae
Formicariidae_Hylopezus_auricularis	Formicariidae
Formicariidae_Hylopezus_macularius	Formicariidae
Thamnophilidae_Hypocnemoides_melanopogon	Thamnophilidae
Galbulidae_Jacamerops_aureus	Galbulidae
Tyrannidae_Knipolegus_orenocensis	Tyrannidae
Tyrannidae_Knipolegus_poecilocercus	Tyrannidae
Rallidae_Laterallus_exilis	Rallidae
Furnariidae_Leptasthenura_andicola	Furnariidae
Trochilidae_Leucippus_taczanowskii	Trochilidae
Anatidae_Lophonetta_specularioides	Anatidae
Trochilidae_Lophornis_gouldii	Trochilidae
Trochilidae_Lophornis_stictolophus	Trochilidae
Tyrannidae_Lophotriccus_eulophotes	Tyrannidae
Bucconidae_Malacoptila_fulvogularis	Bucconidae
Bucconidae_Malacoptila_fusca	Bucconidae
Bucconidae_Malacoptila_rufa	Bucconidae
Strigidae_Megascops_albogularis	Strigidae
Strigidae_Megascops_ingens	Strigidae
Strigidae_Megascops_marshalli	Strigidae
Strigidae_Megascops_petersoni	Strigidae
Strigidae_Megascops_watsonii	Strigidae
Picidae_Melanerpes_cruentatus	Picidae
Threskiornithidae_Mesembrinibis_cayennensis	Threskiornithidae
Falconidae_Micrastur_buckleyi	Falconidae
Falconidae_Micrastur_mintoni	Falconidae
Falconidae_Micrastur_mirandollei	Falconidae
Falconidae_Micrastur_ruficollis	Falconidae
Certhiidae_Microbates_collaris	Certhiidae
Bucconidae_Micromonacha_lanceolata	Bucconidae
Rallidae_Micropygia_schomburgkii	Rallidae
Bucconidae_Monasa_atra	Bucconidae
Bucconidae_Monasa_flavirostris	Bucconidae
Bucconidae_Monasa_morphoeus	Bucconidae
Bucconidae_Monasa_nigrifrons	Bucconidae
Tyrannidae_Myiozetetes_granadensis	Tyrannidae
Thamnophilidae_Myrmoborus_lugubris	Thamnophilidae
Thamnophilidae_Myrmoborus_melanurus	Thamnophilidae
Thamnophilidae_Myrmotherula_fjeldsaai	Thamnophilidae
Thamnophilidae_Myrmotherula_guttata	Thamnophilidae
Thamnophilidae_Myrmotherula_sunensis	Thamnophilidae
Rallidae_Neocrex_erythrops	Rallidae
Neomorphidae_Neomorphus_pucheranii	Neomorphidae
Neomorphidae_Neomorphus_squamiger	Neomorphidae
Tyrannidae_Nephelomyias_lintoni	Tyrannidae
Tyrannidae_Nephelomyias_ochraceiventris	Tyrannidae
Tyrannidae_Nephelomyias_pulcher	Tyrannidae
Anatidae_Netta_erythrophthalma	Anatidae
Anatidae_Nomonyx_dominicus	Anatidae
Bucconidae_Nonnula_brunnea	Bucconidae
Bucconidae_Nonnula_ruficapilla	Bucconidae
Bucconidae_Nonnula_sclateri	Bucconidae
Bucconidae_Notharchus_ordii	Bucconidae
Bucconidae_Notharchus_tectus	Bucconidae
Tinamidae_Nothocercus_bonapartei	Tinamidae
Tinamidae_Nothocercus_nigrocapillus	Tinamidae
Tinamidae_Nothoprocta_ornata	Tinamidae
Tinamidae_Nothura_boraquira	Tinamidae
Bucconidae_Nystalus_chacuru	Bucconidae
Bucconidae_Nystalus_striolatus	Bucconidae
Odontophoridae_Odontophorus_balliviani	Odontophoridae
Odontophoridae_Odontophorus_gujanensis	Odontophoridae
Odontophoridae_Odontophorus_speciosus	Odontophoridae
Odontophoridae_Odontophorus_stellatus	Odontophoridae
Certhiidae_Odontorchilus_branickii	Certhiidae
Fringillidae_Oryzoborus_atrirostris	Fringillidae
Apodidae_Panyptila_cayennensis	Apodidae
Rallidae_Pardirallus_nigricans	Rallidae
Rallidae_Pardirallus_sanguinolentus	Rallidae
Thamnophilidae_Percnostola_arenarum	Thamnophilidae
Trochilidae_Phaethornis_nattereri	Trochilidae
Trochilidae_Phaethornis_rupurumii	Trochilidae
Trochilidae_Phaethornis_stuarti	Trochilidae
Furnariidae_Philydor_erythrocercum	Furnariidae
Furnariidae_Philydor_erythropterum	Furnariidae
Furnariidae_Philydor_rufum	Furnariidae
Trochilidae_Phlogophilus_harterti	Trochilidae
Cotingidae_Phoenicircus_carnifex	Cotingidae
Tyrannidae_Phylloscartes_orbitalis	Tyrannidae
Picidae_Picumnus_albosquamatus	Picidae
Picidae_Picumnus_castelnau	Picidae
Picidae_Picumnus_dorbignyanus	Picidae
Picidae_Picumnus_fuscus	Picidae
Picidae_Picumnus_lafresnayi	Picidae
Picidae_Picumnus_squamulatus	Picidae
Picidae_Picumnus_steindachneri	Picidae
Picidae_Picumnus_subtilis	Picidae
Picidae_Picumnus_varzeae	Picidae
Ardeidae_Pilherodius_pileatus	Ardeidae
Pipridae_Pipra_chloromeros	Pipridae
Pipridae_Pipra_coronota	Pipridae
Pipridae_Pipra_iris	Pipridae
Pipridae_Pipra_nattereri	Pipridae
Pipridae_Pipra_serena	Pipridae
Pipridae_Pipra_vilasboasi	Pipridae
Cotingidae_Pipreola_lubomirskii	Cotingidae
Cotingidae_Pipreola_riefferii	Cotingidae
Tyrannidae_Pitangus_lictor	Tyrannidae
Tyrannidae_Poecilotriccus_calopterus	Tyrannidae
Tyrannidae_Poecilotriccus_pulchellus	Tyrannidae
Tyrannidae_Poecilotriccus_senex	Tyrannidae
Certhiidae_Polioptila_clementsi	Certhiidae
Certhiidae_Polioptila_guianensis	Certhiidae
Falconidae_Polyborus_cheriway	Falconidae
Rallidae_Porzana_albicollis	Rallidae
Furnariidae_Pseudoseisura_unirufa	Furnariidae
Psittacidae_Psilopsiagon_aymara	Psittacidae
Strigidae_Pulsatrix_melanota	Strigidae
Hirundinidae_Pygochelidon_cyanoleuca	Hirundinidae
Thamnophilidae_Rhegmatorhina_berlepschi	Thamnophilidae
Tinamidae_Rhynchotus_maculicollis	Tinamidae
Accipitridae_Rostrhamus_hamatus	Accipitridae
Furnariidae_Schizoeaca_palpebralis	Furnariidae
Furnariidae_Sclerurus_caudacutus	Furnariidae
Furnariidae_Sclerurus_rufigularis	Furnariidae
Rhinocryptidae_Scytalopus_acutirostris	Rhinocryptidae
Rhinocryptidae_Scytalopus_altirostris	Rhinocryptidae
Rhinocryptidae_Scytalopus_bolivianus	Rhinocryptidae
Rhinocryptidae_Scytalopus_macropus	Rhinocryptidae
Rhinocryptidae_Scytalopus_parkeri	Rhinocryptidae
Rhinocryptidae_Scytalopus_simonsi	Rhinocryptidae
Fringillidae_Sicalis_citrina	Fringillidae
Fringillidae_Sicalis_columbiana	Fringillidae
Fringillidae_Sicalis_uropygialis	Fringillidae
Furnariidae_Simoxenops_striatus	Furnariidae
Fringillidae_Sporophila_bouvronides	Fringillidae
Fringillidae_Sporophila_lineola	Fringillidae
Fringillidae_Sporophila_murallae	Fringillidae
Fringillidae_Sporophila_simplex	Fringillidae
Apodidae_Streptoprocne_rutila	Apodidae
Fringillidae_Sturnella_militaris	Fringillidae
Furnariidae_Synallaxis_cherriei	Furnariidae
Furnariidae_Synallaxis_gujanensis	Furnariidae
Furnariidae_Synallaxis_hypospodia	Furnariidae
Furnariidae_Synallaxis_maranonica	Furnariidae
Furnariidae_Synallaxis_moesta	Furnariidae
Furnariidae_Synallaxis_propinqua	Furnariidae
Furnariidae_Synallaxis_unirufa	Furnariidae
Furnariidae_Syndactyla_subalaris	Furnariidae
Apodidae_Tachornis_squamata	Apodidae
Fringillidae_Tangara_phillipsi	Fringillidae
Thamnophilidae_Terenura_spodioptila	Thamnophilidae
Threskiornithidae_Theristicus_caerulescens	Threskiornithidae
Fringillidae_Thlypopsis_ornata	Fringillidae
Fringillidae_Thlypopsis_pectoralis	Fringillidae
Furnariidae_Thripadectes_holostictus	Furnariidae
Furnariidae_Thripadectes_melanorhynchus	Furnariidae
Furnariidae_Thripadectes_scrutator	Furnariidae
Furnariidae_Thripadectes_virgaticeps	Furnariidae
Furnariidae_Thripophaga_berlepschi	Furnariidae
Certhiidae_Thryothorus_eisenmanni	Certhiidae
Tinamidae_Tinamotis_pentlandii	Tinamidae
Tinamidae_Tinamus_major	Tinamidae
Tyrannidae_Todirostrum_chrysocrotaphum	Tyrannidae
Tyrannidae_Tolmomyias_traylori	Tyrannidae
Trochilidae_Topaza_pyra	Trochilidae
Psittacidae_Touit_huetii	Psittacidae
Psittacidae_Touit_stictopterus	Psittacidae
Tyrannidae_Tyrannus_albogularis	Tyrannidae
Furnariidae_Xenops_tenuirostris	Furnariidae
Cotingidae_Xipholena_lamellipennis	Cotingidae
Tyrannidae_Zimmerius_villarejoi	Tyrannidae
